W W W W W W W W W W W W W W W W W W W
W D D D D D D D D W D D D D D D D D W
W D W W D W W W W W W W W W D W W D W
W D D D D D D D D D D D D D D D D D W
W D W W D W D W W W W W D W D W W D W
W D D D D W D D D W D D D W D D D D W
W D W W D W W W E W E W W W D W W D W
W D D W D W E E E E E E E W D W D D W
W D W W D W E W E W E W E W D W W D W
W D D D D E E W 1 E 2 W E E D D D D W
W D W W D W E W W W W W E W D W W D W
W D D W D W E E E E E E E W D W D D W
W D W W D W E W W W W W E W D W W D W
W D D D D D D D D W D D D D D D D D W
W D W W D W W W W W W W W W D W W D W
W D D W D D D D D P D D D D D W D D W
W W D W D W D W W W W W D W D W D W W
W D D D D W D D D W D D D W D D D D W
W D W W W W W W D W D W W W W W W D W
W D D D D D D D D D D D D D D D D D W
W W W W W W W W W W W W W W W W W W W